"filename", "language", "JavaScript", "TypeScript", "JSON", "Markdown", "feature", "comment", "blank", "total"
"e:\Предметы 4 курс\bntu-cypress\README.md", "Markdown", 0, 0, 0, 1, 0, 0, 0, 1
"e:\Предметы 4 курс\bntu-cypress\cypress.json", "JSON", 0, 0, 2, 0, 0, 5, 0, 7
"e:\Предметы 4 курс\bntu-cypress\cypress\fixtures\example.json", "JSON", 0, 0, 5, 0, 0, 0, 0, 5
"e:\Предметы 4 курс\bntu-cypress\cypress\globals.d.ts", "TypeScript", 0, 0, 0, 0, 0, 2, 0, 2
"e:\Предметы 4 курс\bntu-cypress\cypress\integration\courseProject\1createNewCourseProjectTopic.feature", "feature", 0, 0, 0, 0, 15, 0, 4, 19
"e:\Предметы 4 курс\bntu-cypress\cypress\integration\courseProject\2selectCourseProjectTopicByStudent.feature", "feature", 0, 0, 0, 0, 14, 0, 3, 17
"e:\Предметы 4 курс\bntu-cypress\cypress\integration\courseProject\3confirmStudentCourseProjectTopicByLecturer.feature", "feature", 0, 0, 0, 0, 16, 0, 3, 19
"e:\Предметы 4 курс\bntu-cypress\cypress\integration\courseProject\4assignToStudentCourseProjectTopic.feature", "feature", 0, 0, 0, 0, 14, 0, 4, 18
"e:\Предметы 4 курс\bntu-cypress\cypress\integration\courseProject\5editCourseProjectTopic.feature", "feature", 0, 0, 0, 0, 14, 0, 3, 17
"e:\Предметы 4 курс\bntu-cypress\cypress\integration\courseProject\6studentSeeEditedCourseProjectTopic.feature", "feature", 0, 0, 0, 0, 14, 0, 3, 17
"e:\Предметы 4 курс\bntu-cypress\cypress\integration\courseProject\7deleteCourseProjectTopic.feature", "feature", 0, 0, 0, 0, 16, 0, 3, 19
"e:\Предметы 4 курс\bntu-cypress\cypress\integration\graduationProject\1createNewGraduationProjectTopic.feature", "feature", 0, 0, 0, 0, 13, 0, 4, 17
"e:\Предметы 4 курс\bntu-cypress\cypress\integration\graduationProject\2selectGraduationProjectTopicByStudent.feature", "feature", 0, 0, 0, 0, 12, 0, 3, 15
"e:\Предметы 4 курс\bntu-cypress\cypress\integration\graduationProject\3confirmStudentGraduationProjectTopicByLecturer.feature", "feature", 0, 0, 0, 0, 14, 0, 3, 17
"e:\Предметы 4 курс\bntu-cypress\cypress\integration\graduationProject\4assignToStudentGraduationProjectTopic.feature", "feature", 0, 0, 0, 0, 12, 0, 4, 16
"e:\Предметы 4 курс\bntu-cypress\cypress\integration\graduationProject\5editGraduationProjectTopic.feature", "feature", 0, 0, 0, 0, 12, 0, 3, 15
"e:\Предметы 4 курс\bntu-cypress\cypress\integration\graduationProject\6studentSeeEditedGraduationProjectTopic.feature", "feature", 0, 0, 0, 0, 12, 0, 3, 15
"e:\Предметы 4 курс\bntu-cypress\cypress\integration\graduationProject\7deleteGraduationProjectTopic.feature", "feature", 0, 0, 0, 0, 14, 0, 3, 17
"e:\Предметы 4 курс\bntu-cypress\cypress\integration\interactiveBook\1createNewInteractiveBookTopic.feature", "feature", 0, 0, 0, 0, 11, 0, 3, 14
"e:\Предметы 4 курс\bntu-cypress\cypress\integration\interactiveBook\2addTextToInteractiveBookTopic.feature", "feature", 0, 0, 0, 0, 11, 0, 3, 14
"e:\Предметы 4 курс\bntu-cypress\cypress\integration\interactiveBook\3addInteractiveBookChildTopic.feature", "feature", 0, 0, 0, 0, 13, 0, 3, 16
"e:\Предметы 4 курс\bntu-cypress\cypress\integration\interactiveBook\4deleteInteractiveBookChildTopic.feature", "feature", 0, 0, 0, 0, 9, 0, 3, 12
"e:\Предметы 4 курс\bntu-cypress\cypress\integration\interactiveBook\5editInteractiveBookTopic.feature", "feature", 0, 0, 0, 0, 11, 0, 4, 15
"e:\Предметы 4 курс\bntu-cypress\cypress\integration\interactiveBook\6deleteInteractiveBookTopic.feature", "feature", 0, 0, 0, 0, 8, 0, 4, 12
"e:\Предметы 4 курс\bntu-cypress\cypress\plugins\index.js", "JavaScript", 23, 0, 0, 0, 0, 4, 4, 31
"e:\Предметы 4 курс\bntu-cypress\cypress\support\commands.js", "JavaScript", 5, 0, 0, 0, 0, 30, 2, 37
"e:\Предметы 4 курс\bntu-cypress\cypress\support\index.js", "JavaScript", 3, 0, 0, 0, 0, 18, 2, 23
"e:\Предметы 4 курс\bntu-cypress\cypress\support\step_definitions\courseProject.ts", "TypeScript", 0, 91, 0, 0, 0, 0, 17, 108
"e:\Предметы 4 курс\bntu-cypress\cypress\support\step_definitions\graduationProject.ts", "TypeScript", 0, 99, 0, 0, 0, 0, 18, 117
"e:\Предметы 4 курс\bntu-cypress\cypress\support\step_definitions\hooks.ts", "TypeScript", 0, 8, 0, 0, 0, 1, 4, 13
"e:\Предметы 4 курс\bntu-cypress\cypress\support\step_definitions\interactiveBook.ts", "TypeScript", 0, 56, 0, 0, 0, 1, 16, 73
"e:\Предметы 4 курс\bntu-cypress\cypress\support\step_definitions\login.ts", "TypeScript", 0, 18, 0, 0, 0, 0, 4, 22
"e:\Предметы 4 курс\bntu-cypress\cypress\support\step_definitions\mainSchedule.ts", "TypeScript", 0, 16, 0, 0, 0, 0, 3, 19
"e:\Предметы 4 курс\bntu-cypress\cypress\support\step_definitions\subject.ts", "TypeScript", 0, 8, 0, 0, 0, 0, 3, 11
"e:\Предметы 4 курс\bntu-cypress\cypress\support\step_definitions\world.ts", "TypeScript", 0, 0, 0, 0, 0, 6, 1, 7
"e:\Предметы 4 курс\bntu-cypress\cypress\webpack.config.js", "JavaScript", 27, 0, 0, 0, 0, 1, 0, 28
"e:\Предметы 4 курс\bntu-cypress\elements\button.ts", "TypeScript", 0, 20, 0, 0, 0, 3, 3, 26
"e:\Предметы 4 курс\bntu-cypress\elements\checkbox.ts", "TypeScript", 0, 25, 0, 0, 0, 6, 6, 37
"e:\Предметы 4 курс\bntu-cypress\elements\contextMenu.ts", "TypeScript", 0, 20, 0, 0, 0, 14, 6, 40
"e:\Предметы 4 курс\bntu-cypress\elements\element.ts", "TypeScript", 0, 242, 0, 0, 0, 79, 40, 361
"e:\Предметы 4 курс\bntu-cypress\elements\index.ts", "TypeScript", 0, 8, 0, 0, 0, 0, 1, 9
"e:\Предметы 4 курс\bntu-cypress\elements\input.ts", "TypeScript", 0, 16, 0, 0, 0, 8, 5, 29
"e:\Предметы 4 курс\bntu-cypress\elements\label.ts", "TypeScript", 0, 7, 0, 0, 0, 0, 1, 8
"e:\Предметы 4 курс\bntu-cypress\elements\select.ts", "TypeScript", 0, 22, 0, 0, 0, 14, 7, 43
"e:\Предметы 4 курс\bntu-cypress\elements\textArea.ts", "TypeScript", 0, 14, 0, 0, 0, 5, 2, 21
"e:\Предметы 4 курс\bntu-cypress\forms\baseForm.ts", "TypeScript", 0, 2, 0, 0, 0, 0, 0, 2
"e:\Предметы 4 курс\bntu-cypress\forms\dialogForm.ts", "TypeScript", 0, 14, 0, 0, 0, 0, 7, 21
"e:\Предметы 4 курс\bntu-cypress\forms\headerForm.ts", "TypeScript", 0, 19, 0, 0, 0, 0, 8, 27
"e:\Предметы 4 курс\bntu-cypress\forms\projectTopicForm.ts", "TypeScript", 0, 115, 0, 0, 0, 0, 20, 135
"e:\Предметы 4 курс\bntu-cypress\forms\studentListForm.ts", "TypeScript", 0, 36, 0, 0, 0, 0, 10, 46
"e:\Предметы 4 курс\bntu-cypress\package-lock.json", "JSON", 0, 0, 8852, 0, 0, 0, 1, 8853
"e:\Предметы 4 курс\bntu-cypress\package.json", "JSON", 0, 0, 24, 0, 0, 0, 1, 25
"e:\Предметы 4 курс\bntu-cypress\pages\basePage.ts", "TypeScript", 0, 16, 0, 0, 0, 0, 4, 20
"e:\Предметы 4 курс\bntu-cypress\pages\graduationProgectPage\graduationProjectPage.ts", "TypeScript", 0, 21, 0, 0, 0, 0, 8, 29
"e:\Предметы 4 курс\bntu-cypress\pages\loginPage.ts", "TypeScript", 0, 19, 0, 0, 0, 6, 5, 30
"e:\Предметы 4 курс\bntu-cypress\pages\mainSchedulePage.ts", "TypeScript", 0, 14, 0, 0, 0, 0, 6, 20
"e:\Предметы 4 курс\bntu-cypress\pages\subjectPage\courseProgectPage\courseProjectPage.ts", "TypeScript", 0, 21, 0, 0, 0, 0, 8, 29
"e:\Предметы 4 курс\bntu-cypress\pages\subjectPage\interactiveBookPage.ts", "TypeScript", 0, 93, 0, 0, 0, 0, 24, 117
"e:\Предметы 4 курс\bntu-cypress\pages\subjectPage\subjectPage.ts", "TypeScript", 0, 25, 0, 0, 0, 0, 7, 32
"e:\Предметы 4 курс\bntu-cypress\testData\graduationProject.json", "JSON", 0, 0, 14, 0, 0, 0, 0, 14
"e:\Предметы 4 курс\bntu-cypress\tsconfig.json", "JSON", 0, 0, 8, 0, 0, 0, 0, 8
"e:\Предметы 4 курс\bntu-cypress\types\element.ts", "TypeScript", 0, 15, 0, 0, 0, 0, 1, 16
"e:\Предметы 4 курс\bntu-cypress\types\index.ts", "TypeScript", 0, 1, 0, 0, 0, 0, 0, 1
"e:\Предметы 4 курс\bntu-cypress\utils\apiUtils\requests.js", "JavaScript", 39, 0, 0, 0, 0, 10, 10, 59
"e:\Предметы 4 курс\bntu-cypress\utils\arrayUtils\arrayUtils.js", "JavaScript", 26, 0, 0, 0, 0, 0, 4, 30
"e:\Предметы 4 курс\bntu-cypress\utils\databaseUtils\database.js", "JavaScript", 37, 0, 0, 0, 0, 0, 6, 43
"e:\Предметы 4 курс\bntu-cypress\utils\randomGenerateUtils\randomNumber.js", "JavaScript", 27, 0, 0, 0, 0, 0, 8, 35
"e:\Предметы 4 курс\bntu-cypress\utils\randomGenerateUtils\randomString.js", "JavaScript", 14, 0, 0, 0, 0, 0, 2, 16
"e:\Предметы 4 курс\bntu-cypress\utils\stringUtils\stringUtils.js", "JavaScript", 22, 0, 0, 0, 0, 0, 6, 28
"Total", "-", 223, 1081, 8905, 1, 255, 213, 357, 11035